Lupus
An Interactive Fiction by Gruppe 8
Release 1 / Serial number 180523 / Inform 7 build 6M62 (I6/v6.33 lib 6/12N) SD

Hangar
Du bist in dem Hangar.

You can see Hangar-Luke, Tür zwischen Andockbucht und Hangar, Sicherheitsausweis, Barry and Blinkender_Knopf here.

>u
(first opening Tür zwischen Andockbucht und Hangar)

Hangar
Du bist in dem Hangar.

You can see Hangar-Luke, Tür zwischen Andockbucht und Hangar and Sicherheitsausweis here.

>take sa
Taken.

>be sa u
Der Durchgang ist nun offen.

>u
Gamma-Kreuzung
Du bist in der Gamma-Kreuzung.

You can see Xeno Lab Luke, Hangar-Luke, two Tür_Sicherheits, Laborkittel and Leiche here.

Die Luke zwischen Hangar und Gamma Kreuzung schließt sich wieder.

* * *

Lupus
An Interactive Fiction by Gruppe 8
Release 1 / Serial number 180523 / Inform 7 build 6M62 (I6/v6.33 lib 6/12N) SD

Hangar
Du bist in dem Hangar.

You can see Hangar-Luke, Tür zwischen Andockbucht und Hangar, Sicherheitsausweis, Barry and Blinkender_Knopf here.

>n
You can't go that way.

>s
You can't go that way.

>up
(first opening Tür zwischen Andockbucht und Hangar)

Hangar
Du bist in dem Hangar.

You can see Hangar-Luke, Tür zwischen Andockbucht und Hangar, Sicherheitsausweis, Percy, Barry and Blinkender_Knopf here.

>push Blinkender_Knopf
TEST

* * *

>s
You can't go that way.

>d
(first opening Tür zwischen Andockbucht und Hangar)

Andockbucht
Du bist in der Andockbucht.

You can see Tür zwischen Andockbucht und Kommunkationsbasis and Tür zwischen Andockbucht und Hangar here.

>n
(first opening Tür zwischen Andockbucht und Kommunkationsbasis)

Kommunikationsbasis
Du bist in der Kommunikationsbasis

You can see Tür zwischen Andockbucht und Kommunkationsbasis here.

* * *

>s
You can't go that way.

>e
You can't go that way.

>w
You can't go that way.

>d
(first opening Tür zwischen Andockbucht und Hangar)

Andockbucht
Du bist in der Andockbucht.

You can see Tür zwischen Andockbucht und Kommunkationsbasis and Tür zwischen Andockbucht und Hangar here.

>n
(first opening Tür zwischen Andockbucht und Kommunkationsbasis)

Kommunikationsbasis
Du bist in der Kommunikationsbasis

You can see Luke zwischen KommunikationsModul und Gamma Delta Korridor. and Tür zwischen Andockbucht und Kommunkationsbasis here.

>u
Sauerstoffabfall im äußeren Ring
(first opening Luke zwischen KommunikationsModul und Gamma Delta Korridor.)

Gamma-Delta-Korridor
Du bist in der Gamma-Delta-Korridor.

You can see Luke zwischen KommunikationsModul und Gamma Delta Korridor., Tür zwischen Gamma Delta Kreuzung und Delta Kreuzung, Tür zwischen Gamma Kreuzung und Gamma Delta Kreuzung and Hebel here.

Der Sauerstoff reicht noch 7 Züge.

>down
Kommunikationsbasis
Du bist in der Kommunikationsbasis

You can see Luke zwischen KommunikationsModul und Gamma Delta Korridor. and Tür zwischen Andockbucht und Kommunkationsbasis here.

>look
Kommunikationsbasis
Du bist in der Kommunikationsbasis

You can see Luke zwischen KommunikationsModul und Gamma Delta Korridor. and Tür zwischen Andockbucht und Kommunkationsbasis here.

>n
You can't go that way.

>up
Sauerstoffabfall im äußeren Ring
Gamma-Delta-Korridor
Du bist in der Gamma-Delta-Korridor.

You can see Luke zwischen KommunikationsModul und Gamma Delta Korridor., Tür zwischen Gamma Delta Kreuzung und Delta Kreuzung, Tür zwischen Gamma Kreuzung und Gamma Delta Kreuzung and Hebel here.

Der Sauerstoff reicht noch 6 Züge.

>n
(first opening Tür zwischen Gamma Delta Kreuzung und Delta Kreuzung)
It seems to be locked.

Der Sauerstoff reicht noch 5 Züge.

>n
(first opening Tür zwischen Gamma Delta Kreuzung und Delta Kreuzung)
It seems to be locked.

Der Sauerstoff reicht noch 4 Züge.

>n
(first opening Tür zwischen Gamma Delta Kreuzung und Delta Kreuzung)
It seems to be locked.

Der Sauerstoff reicht noch 3 Züge.

>down
Kommunikationsbasis
Du bist in der Kommunikationsbasis

You can see Luke zwischen KommunikationsModul und Gamma Delta Korridor. and Tür zwischen Andockbucht und Kommunkationsbasis here.

>up
Sauerstoffabfall im äußeren Ring
Gamma-Delta-Korridor
Du bist in der Gamma-Delta-Korridor.

You can see Luke zwischen KommunikationsModul und Gamma Delta Korridor., Tür zwischen Gamma Delta Kreuzung und Delta Kreuzung, Tür zwischen Gamma Kreuzung und Gamma Delta Kreuzung and Hebel here.

Der Sauerstoff reicht noch 2 Züge.

>s
(first opening Tür zwischen Gamma Kreuzung und Gamma Delta Kreuzung)
It seems to be locked.

Der Sauerstoff reicht noch 1 Züge.

>up
You can't go that way.

Der Sauerstoff reicht noch 0 Züge.
Der Sauerstoff ist dir ausgegangen.

    *** The End ***

Would you like to RESTART, RESTORE a saved game, QUIT or UNDO the last command?

* * *

>n
You can't go that way.

>up
You can't go that way.

>look
Kommunikationsbasis
Du bist in der Kommunikationsbasis

You can see Tür zwischen Andockbucht und Kommunkationsbasis here.

>look TÜR_KommunikationsModulZUGammaDeltaKorridor
You can't see any such thing.

* * *

Lupus
An Interactive Fiction by Gruppe 8
Release 1 / Serial number 180523 / Inform 7 build 6M62 (I6/v6.33 lib 6/12N) SD

Hangar
Du bist in dem Hangar.

You can see Hangar-Luke, Tür zwischen Andockbucht und Hangar, Sicherheitsausweis, Barry and Blinkender_Knopf here.

>look kontaminierter
You can't see any such thing.

>look kontaminierterPercy
You see nothing special about Kontaminierter.

>look KontaminierterPercy
You see nothing special about Kontaminierter.

>wait
Time passes.

Der Kontaminierte kommt dir ziemlich nah. Du solltest besser verschwinden.

>wait
Time passes.

GAME OVER

    *** The End ***

Would you like to RESTART, RESTORE a saved game, QUIT or UNDO the last command?

* * *

Lupus
An Interactive Fiction by Gruppe 8
Release 1 / Serial number 180523 / Inform 7 build 6M62 (I6/v6.33 lib 6/12N) SD

Hangar
Du bist in dem Hangar.

You can see Hangar-Luke, Tür zwischen Andockbucht und Hangar, Sicherheitsausweis, Barry and Blinkender_Knopf here.

>push Blinkender_Knopf
TEST

>look
Hangar
Du bist in dem Hangar.

You can see Kontaminierter, Hangar-Luke, Tür zwischen Andockbucht und Hangar, Sicherheitsausweis and Blinkender_Knopf here.

>look self
As good-looking as ever.

Der Kontaminierte kommt dir ziemlich nah. Du solltest besser verschwinden.

>look
Hangar
Du bist in dem Hangar.

You can see Kontaminierter, Hangar-Luke, Tür zwischen Andockbucht und Hangar, Sicherheitsausweis and Blinkender_Knopf here.

GAME OVER

    *** The End ***

Would you like to RESTART, RESTORE a saved game, QUIT or UNDO the last command?

* * *

Lupus
An Interactive Fiction by Gruppe 8
Release 1 / Serial number 180523 / Inform 7 build 6M62 (I6/v6.33 lib 6/12N) SD

Hangar
Du bist in dem Hangar.

You can see Hangar-Luke, Tür zwischen Andockbucht und Hangar, Sicherheitsausweis, Barry and Blinkender_Knopf here.

>up
(first opening Hangar-Luke)
It seems to be locked.

>d
You can't go that way.

>n
You can't go that way.

>s
(first opening Tür zwischen Andockbucht und Kommunkationsbasis)

Andockbucht
Du bist in der Andockbucht.

You can see Tür zwischen Andockbucht und Kommunkationsbasis and Tür zwischen Andockbucht und Hangar here.

>n
Kommunikationsbasis
Du bist in der Kommunikationsbasis

You can see Tür zwischen Andockbucht und Kommunkationsbasis here.

>n
You can't go that way.

>e
Antennen Array
Du bist im Antennen Array raum.

>w
Kommunikationsbasis
Du bist in der Kommunikationsbasis

You can see Tür zwischen Andockbucht und Kommunkationsbasis here.

>w
Hilfsgenerator
Du bist im Hilfsgenerator Raum.

>up
You can't go that way.

* * *

>up
(first opening Hangar-Luke)
It seems to be locked.

>open hangar-luke
You can't see any such thing.

>take all
Sicherheitsausweis: Taken.
Blinkender_Knopf: Taken.

>up
(first opening Hangar-Luke)
It seems to be locked.

>unlock
What do you want to unlock?

>hangar-luke
You can't see any such thing.

>look
Hangar
Du bist in dem Hangar.

You can see Hangar-Luke, Tür zwischen Andockbucht und Hangar and Barry here.

>up
(first opening Hangar-Luke)
It seems to be locked.

* * *

>open hangar-luke
You can't see any such thing.

>open Luke_HangarZUGammaKreuz
It seems to be locked.

>unlock Luke_HangarZUGammaKreuz
What do you want to unlock Hangar-Luke with?

>sicherheitsausweis
That doesn't seem to fit the lock.

>inventory
You are carrying:
  Blinkender_Knopf
  Sicherheitsausweis

* * *

Lupus
An Interactive Fiction by Gruppe 8
Release 1 / Serial number 180523 / Inform 7 build 6M62 (I6/v6.33 lib 6/12N) SD

Hangar
Du bist in dem Hangar.

You can see Hangar-Luke, Tür zwischen Andockbucht und Hangar, Sicherheitsausweis, Barry and Blinkender_Knopf here.

>down
Sauerstoffabfall im äußeren Ring
(first opening Tür zwischen Andockbucht und Hangar)

Andockbucht
Du bist in der Andockbucht.

You can see Tür zwischen Andockbucht und Kommunkationsbasis and Tür zwischen Andockbucht und Hangar here.

Der Sauerstoff reicht noch 7 Züge.

>look
Andockbucht
Du bist in der Andockbucht.

You can see Tür zwischen Andockbucht und Kommunkationsbasis and Tür zwischen Andockbucht und Hangar here.

Der Sauerstoff reicht noch 6 Züge.

>look
Andockbucht
Du bist in der Andockbucht.

You can see Tür zwischen Andockbucht und Kommunkationsbasis and Tür zwischen Andockbucht und Hangar here.

Der Sauerstoff reicht noch 5 Züge.

>look
Andockbucht
Du bist in der Andockbucht.

You can see Tür zwischen Andockbucht und Kommunkationsbasis and Tür zwischen Andockbucht und Hangar here.

Der Sauerstoff reicht noch 4 Züge.

>look
Andockbucht
Du bist in der Andockbucht.

You can see Tür zwischen Andockbucht und Kommunkationsbasis and Tür zwischen Andockbucht und Hangar here.

Der Sauerstoff reicht noch 3 Züge.

>look
Andockbucht
Du bist in der Andockbucht.

You can see Tür zwischen Andockbucht und Kommunkationsbasis and Tür zwischen Andockbucht und Hangar here.

Der Sauerstoff reicht noch 2 Züge.

>look
Andockbucht
Du bist in der Andockbucht.

You can see Tür zwischen Andockbucht und Kommunkationsbasis and Tür zwischen Andockbucht und Hangar here.

Der Sauerstoff reicht noch 1 Züge.

>look
Andockbucht
Du bist in der Andockbucht.

You can see Tür zwischen Andockbucht und Kommunkationsbasis and Tür zwischen Andockbucht und Hangar here.

Der Sauerstoff reicht noch 0 Züge.
Der Sauerstoff ist dir ausgegangen.

    *** The End ***

Would you like to RESTART, RESTORE a saved game, QUIT or UNDO the last command?

* * *

>down
Sauerstoffabfall im äußeren Ring
(first opening Tür zwischen Andockbucht und Hangar)

Andockbucht
Du bist in der Andockbucht.

You can see Tür zwischen Andockbucht und Kommunkationsbasis and Tür zwischen Andockbucht und Hangar here.

Der Sauerstoff reicht noch 7 Züge.

>n
(first opening Tür zwischen Andockbucht und Kommunkationsbasis)

Kommunikationsbasis
Du bist in der Kommunikationsbasis

You can see Luke zwischen KommunikationsModul und Gamma Delta Korridor. and Tür zwischen Andockbucht und Kommunkationsbasis here.

>s
Andockbucht
Du bist in der Andockbucht.

You can see Tür zwischen Andockbucht und Kommunkationsbasis and Tür zwischen Andockbucht und Hangar here.

Der Sauerstoff reicht noch 6 Züge.

>up
Hangar
Du bist in dem Hangar.

You can see Tür zwischen Andockbucht und Hangar, Hangar-Luke, Sicherheitsausweis, Barry and Blinkender_Knopf here.

Der Sauerstoff reicht noch 5 Züge.

>look
Hangar
Du bist in dem Hangar.

You can see Tür zwischen Andockbucht und Hangar, Hangar-Luke, Sicherheitsausweis, Barry and Blinkender_Knopf here.

Der Sauerstoff reicht noch 4 Züge.

>look
Hangar
Du bist in dem Hangar.

You can see Tür zwischen Andockbucht und Hangar, Hangar-Luke, Sicherheitsausweis, Barry and Blinkender_Knopf here.

Der Sauerstoff reicht noch 3 Züge.

>look
Hangar
Du bist in dem Hangar.

You can see Tür zwischen Andockbucht und Hangar, Hangar-Luke, Sicherheitsausweis, Barry and Blinkender_Knopf here.

Der Sauerstoff reicht noch 2 Züge.

>look
Hangar
Du bist in dem Hangar.

You can see Tür zwischen Andockbucht und Hangar, Hangar-Luke, Sicherheitsausweis, Barry and Blinkender_Knopf here.

Der Sauerstoff reicht noch 1 Züge.

>look
Hangar
Du bist in dem Hangar.

You can see Tür zwischen Andockbucht und Hangar, Hangar-Luke, Sicherheitsausweis, Barry and Blinkender_Knopf here.

Der Sauerstoff reicht noch 0 Züge.
Der Sauerstoff ist dir ausgegangen.

    *** The End ***

Would you like to RESTART, RESTORE a saved game, QUIT or UNDO the last command?

* * *

Lupus
An Interactive Fiction by Gruppe 8
Release 1 / Serial number 180523 / Inform 7 build 6M62 (I6/v6.33 lib 6/12N) SD

Hangar
Du bist in dem Hangar.

You can see Hangar-Luke, Tür zwischen Andockbucht und Hangar, Sicherheitsausweis, Barry and Blinkender_Knopf here.

>s
You can't go that way.

>down
TEST
(first opening Tür zwischen Andockbucht und Hangar)

Andockbucht
Du bist in der Andockbucht.

You can see Tür zwischen Andockbucht und Kommunkationsbasis and Tür zwischen Andockbucht und Hangar here.

true

>n
(first opening Tür zwischen Andockbucht und Kommunkationsbasis)

Kommunikationsbasis
Du bist in der Kommunikationsbasis

You can see Tür zwischen Andockbucht und Kommunkationsbasis here.

>s
Andockbucht
Du bist in der Andockbucht.

You can see Tür zwischen Andockbucht und Kommunkationsbasis and Tür zwischen Andockbucht und Hangar here.

true

>n
Kommunikationsbasis
Du bist in der Kommunikationsbasis

You can see Tür zwischen Andockbucht und Kommunkationsbasis here.

>look
Kommunikationsbasis
Du bist in der Kommunikationsbasis

You can see Tür zwischen Andockbucht und Kommunkationsbasis here.

* * *

Lupus
An Interactive Fiction by Gruppe 8
Release 1 / Serial number 180523 / Inform 7 build 6M62 (I6/v6.33 lib 6/12N) SD

Hangar
Du bist in dem Hangar.

You can see Hangar-Luke, Tür zwischen Andockbucht und Hangar, Sicherheitsausweis, Barry and Blinkender_Knopf here.

>look
Hangar
Du bist in dem Hangar.

You can see Hangar-Luke, Tür zwischen Andockbucht und Hangar, Sicherheitsausweis, Barry and Blinkender_Knopf here.

>look
Hangar
Du bist in dem Hangar.

You can see Hangar-Luke, Tür zwischen Andockbucht und Hangar, Sicherheitsausweis, Barry and Blinkender_Knopf here.

I beg your pardon?

I beg your pardon?