Lupus
An Interactive Fiction by Gruppe 8
Release 1 / Serial number 180628 / Inform 7 build 6M62 (I6/v6.33 lib 6/12N) SD

Andockbucht
Du bist in der Andockbucht.

You can see Tür zwischen Andockbucht und Kommunkationsbasis, Tür zwischen Andockbucht und Hangar and Raumfähre (in which are Antigravitationsgreifer and Palette) here.

>u
(first opening Tür zwischen Andockbucht und Hangar)

Hangar
Du bist in dem Hangar.

Barry standing  in der Nähe.

You can also see Hangar-Luke, Tür zwischen Andockbucht und Hangar and a Spind (in which are Sicherheitsausweis and Mobitab) here.

>look spind
Ein Spind in dem Ausrüstung der Besatzung aufbewahrt wird.

In the Spind are Sicherheitsausweis and Mobitab.

>take all
Sicherheitsausweis: Taken.
Mobitab: Taken.

>u
(first opening Hangar-Luke)
It seems to be locked.

>sa u
That's not a verb I recognise.

>benutzen sa up
That's not a verb I recognise.

* * *

>u
Gamma-Kreuzung
Du bist in der Gamma-Kreuzung.

You can see Xeno Lab Luke, Hangar-Luke, Tür zwischen Gamma Kreuzung und Gamma Delta Kreuzung, Tür zwischen Gamma Beta Kreuzung und Gamma Kreuzung, Laborkittel and Leiche here.

Du hörst den Stationsalarm, der die meisten Geräusche übertönen würde.

Die Luke zwischen Hangar und Gamma Kreuzung schließt sich wieder.

>n
(first opening Tür zwischen Gamma Kreuzung und Gamma Delta Kreuzung)
It seems to be locked.

Du hörst den Stationsalarm, der die meisten Geräusche übertönen würde.

* * *

>n
Delta-Kreuzung
Du bist in der Delta-Kreuzung.

You can see Solar Lab Luke, Tür zwischen Delta Kreuzung und Alpha Delta Kreuzung and Tür zwischen Gamma Delta Kreuzung und Delta Kreuzung here.

Du hörst den Stationsalarm, der die meisten Geräusche übertönen würde.

>benutze sa n
Der Durchgang ist nun offen.

>n
Alpha-Delta-Korridor
Du bist in dem Alpha-Delta-Korridor.

Kontaminierter standing  in der Nähe.

You can also see Tür zwischen Alpha Delta Kreuzung und Alpha Kreuzung and Tür zwischen Delta Kreuzung und Alpha Delta Kreuzung here.

Du hörst den Stationsalarm, der die meisten Geräusche übertönen würde.

Kontaminationsalarm! In der Nähe befindet sich ein Kontaminierter.

>benutze sa n
Der Durchgang ist nun offen.

* * *

>n
Alpha-Kreuzung
Du bist in der Alpha-Kreuzung.

You can see Med Lab Luke, Tür zwischen Alpha Kreuzung und Alpha Beta Kreuzung, Tür zwischen Alpha Delta Kreuzung und Alpha Kreuzung and Tür zwischen Alpha Kreuzung und Dienstzimmer here.

Du hörst den Stationsalarm, der die meisten Geräusche übertönen würde.

>u
(first opening Med Lab Luke)

Med Lab
Du bist im Med Lab. Durch das Fenster in der Decke kannst du den Maschinenkern grün glühen sehen.

Kontaminierter standing  in der Nähe.

You can also see Med Lab Luke and Krankenbett (empty) here.

Kontaminationsalarm! In der Nähe befindet sich ein Kontaminierter.

* * *

>u
(first opening Tür zwischen Andockbucht und Hangar)

Hangar
Du bist in dem Hangar.

Barry standing  in der Nähe.

You can also see Hangar-Luke, Tür zwischen Andockbucht und Hangar and a Spind (in which are Sicherheitsausweis and Mobitab) here.

>up
(first opening Luke zwischen Alpha KI und Lagerraum)
It seems to be locked.

Du hörst den Stationsalarm, der die meisten Geräusche übertönen würde.

>push AlphaKI-Hebel
TEST
Du hörst den Stationsalarm, der die meisten Geräusche übertönen würde.

* * *

Lupus
An Interactive Fiction by Gruppe 8
Release 1 / Serial number 180628 / Inform 7 build 6M62 (I6/v6.33 lib 6/12N) SD

Andockbucht
Du bist in der Andockbucht.

You can see Tür zwischen Andockbucht und Kommunkationsbasis, Tür zwischen Andockbucht und Hangar and Raumfähre (in which are Antigravitationsgreifer and Palette) here.

>d
You can't go that way.

>u
(first opening Tür zwischen Andockbucht und Hangar)

Hangar
Du bist in dem Hangar.

Barry standing  in der Nähe.

You can also see Hangar-Luke, Tür zwischen Andockbucht und Hangar, Sicherheitsausweis and Spind (in which is Mobitab) here.

>look spind
Ein Spind in dem Ausrüstung der Besatzung aufbewahrt wird.

In Spind is Mobitab.

* * *

Lupus
An Interactive Fiction by Gruppe 8
Release 1 / Serial number 180628 / Inform 7 build 6M62 (I6/v6.33 lib 6/12N) SD

Andockbucht
Du bist in der Andockbucht.

You can see Tür zwischen Andockbucht und Kommunkationsbasis, Tür zwischen Andockbucht und Hangar and Raumfähre (in which are Antigravitationsgreifer and Palette) here.

>up
(first opening Tür zwischen Andockbucht und Hangar)

Hangar
Du bist in dem Hangar.

Barry standing  in der Nähe.

You can also see Hangar-Luke, Tür zwischen Andockbucht und Hangar and a Spind (in which are Sicherheitsausweis and Mobitab) here.

Lagerraum
Du bist im Lagerraum.

You can see Luke zwischen Alpha KI und Lagerraum, Luke zwischen Cafeteria und Lagerraum, a Raumanzug and AlphaKI-Hebel here.

Du hörst den Stationsalarm, der die meisten Geräusche übertönen würde.

>up
(first opening Luke zwischen Alpha KI und Lagerraum)
It seems to be locked.

Du hörst den Stationsalarm, der die meisten Geräusche übertönen würde.

>push AlphaKi-Hebel
Die Tür zur Alpha KI wurde entriegelt.

Du hörst den Stationsalarm, der die meisten Geräusche übertönen würde.

>u
(first opening Luke zwischen Alpha KI und Lagerraum)

Alpha KI
Du bist im Alpha KI Raum. Durch das Fenster in der Decke kannst du den Maschinenkern grün glühen sehen.

You can see Luke zwischen Alpha KI und Lagerraum and Tür zwischen Lagerraum und Alpha KI here.

* * *

>up
(first opening Luke zwischen Alpha KI und Lagerraum)
It seems to be locked.

Du hörst den Stationsalarm, der die meisten Geräusche übertönen würde.

>look
Lagerraum
Du bist im Lagerraum.

You can see Luke zwischen Alpha KI und Lagerraum, Luke zwischen Cafeteria und Lagerraum, a Raumanzug and AlphaKI-Hebel here.

Du hörst den Stationsalarm, der die meisten Geräusche übertönen würde.

>look AlphaKI-Hebel
Der Hebel scheint die Luke zur Alpha KI zu entriegeln wenn man ihn drückt.

Du hörst den Stationsalarm, der die meisten Geräusche übertönen würde.

>push AlphaKI-Hebel
Die Tür zur Alpha KI wurde entriegelt.

Du hörst den Stationsalarm, der die meisten Geräusche übertönen würde.

>wait
Time passes.

Du hörst den Stationsalarm, der die meisten Geräusche übertönen würde.

 Die Luke zur Alpha KI hat sich wieder verriegelt.

>push AlphaKI-Hebel
Die Tür zur Alpha KI wurde entriegelt.

Du hörst den Stationsalarm, der die meisten Geräusche übertönen würde.

* * *

>wait
Time passes.

Du hörst den Stationsalarm, der die meisten Geräusche übertönen würde.

 Die Luke zur Alpha KI hat sich wieder verriegelt.

>up
(first opening Luke zwischen Alpha KI und Lagerraum)
It seems to be locked.

Du hörst den Stationsalarm, der die meisten Geräusche übertönen würde.

>push AlphaKI-Hebel
Die Tür zur Alpha KI wurde entriegelt.

Du hörst den Stationsalarm, der die meisten Geräusche übertönen würde.

>up
(first opening Luke zwischen Alpha KI und Lagerraum)

Alpha KI
Du bist im Alpha KI Raum. Durch das Fenster in der Decke kannst du den Maschinenkern grün glühen sehen.

You can see Luke zwischen Alpha KI und Lagerraum and Tür zwischen Lagerraum und Alpha KI here.

* * *

Lupus
An Interactive Fiction by Gruppe 8
Release 1 / Serial number 180628 / Inform 7 build 6M62 (I6/v6.33 lib 6/12N) SD

Andockbucht
Du bist in der Andockbucht.

You can see Tür zwischen Andockbucht und Kommunkationsbasis, Tür zwischen Andockbucht und Hangar and Raumfähre (in which are Antigravitationsgreifer and Palette) here.

>Videoblog anschauen
Ich sehe hier keinen Videoblog.

>MEDLABTEST
Med Lab
Du bist im Med Lab. Durch das Fenster in der Decke kannst du den Maschinenkern grün glühen sehen.

Kontaminierter standing  in der Nähe.

Es scheint einer Art Videoblog auf dem Pult gespeichert zu sein.
Nutze "Videoblog anschauen".

You can also see Med Lab Luke and Krankenbett (empty) here.

>Videoblog anschauen
Der Videoblog des Stationsarztes begint zu spielen:
Es gibt eine biologische Probe, die vom nahegelegenen Alien-Platenen gewonnen wurde.
Aufgrund eines Fehlers bei der Dekonatmination der Raumanzüge sind zahlreiche Mitarbeiter mit einem fremden Erreger kontaminiert worden.
Halten Sie sich von kontaminierten Personen fern!
Bleiben Sie nicht zu lange im gleichen Raum mit einem kontaminierter Person. Sie könnten sich anstecken!

>d
(first opening Med Lab Luke)

Alpha-Kreuzung
Du bist in der Alpha-Kreuzung.

You can see Med Lab Luke, Tür zwischen Alpha Kreuzung und Alpha Beta Kreuzung, Tür zwischen Alpha Kreuzung und Dienstzimmer and Tür zwischen Alpha Delta Kreuzung und Alpha Kreuzung here.

Du hörst den Stationsalarm, der die meisten Geräusche übertönen würde.

>u
Med Lab
Du bist im Med Lab. Durch das Fenster in der Decke kannst du den Maschinenkern grün glühen sehen.

Kontaminierter standing  in der Nähe.

Es scheint einer Art Videoblog auf dem Pult gespeichert zu sein.
Nutze "Videoblog anschauen".

You can also see Med Lab Luke and Krankenbett (empty) here.

* * *

>look
Med Lab
Du bist im Med Lab. Durch das Fenster in der Decke kannst du den Maschinenkern grün glühen sehen.

Kontaminierter standing  in der Nähe.

Es scheint einer Art Videoblog auf dem Pult gespeichert zu sein.
Nutze "Videoblog anschauen".

You can also see Med Lab Luke and Krankenbett (empty) here.

>look
Med Lab
Du bist im Med Lab. Durch das Fenster in der Decke kannst du den Maschinenkern grün glühen sehen.

Kontaminierter standing  in der Nähe.

Es scheint einer Art Videoblog auf dem Pult gespeichert zu sein.
Nutze "Videoblog anschauen".

You can also see Med Lab Luke and Krankenbett (empty) here.

Der Kontaminierte kommt dir ziemlich nah. Du solltest besser verschwinden.

>look
Med Lab
Du bist im Med Lab. Durch das Fenster in der Decke kannst du den Maschinenkern grün glühen sehen.

Kontaminierter standing  in der Nähe.

Es scheint einer Art Videoblog auf dem Pult gespeichert zu sein.
Nutze "Videoblog anschauen".

You can also see Med Lab Luke and Krankenbett (empty) here.

GAME OVER

    *** The End ***

Would you like to RESTART, RESTORE a saved game, QUIT or UNDO the last command?

* * *

Lupus
An Interactive Fiction by Gruppe 8
Release 1 / Serial number 180628 / Inform 7 build 6M62 (I6/v6.33 lib 6/12N) SD

Andockbucht
Du bist in der Andockbucht.

You can see Tür zwischen Andockbucht und Kommunkationsbasis, Tür zwischen Andockbucht und Hangar and Raumfähre (in which are Antigravitationsgreifer and Palette) here.

>COMTEST1
Kommunikationsbasis
Du bist in der Kommunikationsbasis

You can see Luke zwischen KommunikationsModul und Gamma Delta Korridor. and Tür zwischen Andockbucht und Kommunkationsbasis here.

>u
Die Palette, die die Xeno-Lab Luke offen gehalten hat löst sich. Die Palette fliegt durch die Räume und beschädigt eine Bodenluke. Die Luft wird dünn!

(first opening Luke zwischen KommunikationsModul und Gamma Delta Korridor.)

Gamma-Delta-Korridor
Du bist in dem Gamma-Delta-Korridor. Eines der äußeren Fenster wurde beschädigt und ist undicht.

You can see Luke zwischen KommunikationsModul und Gamma Delta Korridor., Tür zwischen Gamma Delta Kreuzung und Delta Kreuzung, Tür zwischen Gamma Kreuzung und Gamma Delta Kreuzung and Hebel here.

Der Sauerstoff reicht noch 7 Züge.

Du hörst den Stationsalarm, der die meisten Geräusche übertönen würde.