Lupus
An Interactive Fiction by Gruppe 8
Release 1 / Serial number 180529 / Inform 7 build 6M62 (I6/v6.33 lib 6/12N) SD

Hangar
Du bist in dem Hangar.

You can see Hangar-Luke, Tür zwischen Andockbucht und Hangar, Blinkender_Knopf, Sicherheitsausweis and Barry here.

>verbinde palette
Du befestigst die Palette am Antigravitationsgreifer. Dieser beginnt zu schweben und schwebt aus der Raumfähre raus. Du kannst jetzt den Antigravitationsgreifer anstoßen.

>u
(first opening Tür zwischen Andockbucht und Hangar)

Hangar
Du bist in dem Hangar.

You can see Hangar-Luke, Tür zwischen Andockbucht und Hangar and Sicherheitsausweis here.

>d
Andockbucht
Du bist in der Andockbucht.

You can see Tür zwischen Andockbucht und Hangar, Antigravitationsgreifer, Tür zwischen Andockbucht und Kommunkationsbasis, You and Raumfähre (empty) here.

>Antigravitationsgreifer anstoßen
Der Antigravitations is in den Raum über dir geschebt.

>u
Hangar
Du bist in dem Hangar.

You can see Tür zwischen Andockbucht und Hangar, Antigravitationsgreifer, Hangar-Luke and Sicherheitsausweis here.

>take Sicherheitsausweis
Taken.

>benutze Sicherheitsausweis u
Der Durchgang ist nun offen.

>Antigravitationsgreifer anstoßen
Der Antigravitations is in den Raum über dir geschebt.

>u
Gamma-Kreuzung
Du bist in der Gamma-Kreuzung.

You can see Xeno Lab Luke, Hangar-Luke, Tür zwischen Gamma Kreuzung und Gamma Delta Kreuzung, Antigravitationsgreifer, Tür zwischen Gamma Beta Kreuzung und Gamma Kreuzung, Laborkittel and Leiche here.

Die Luke zwischen Hangar und Gamma Kreuzung schließt sich wieder.

>wear Laborkittel
(first taking Laborkittel)
You put on Laborkittel.

>u
Ich kann hier nicht durchgehen. Ich muss etwas finden um die Luke zu versperren.

>open Luke_Xeno
Mit dem Transponder im Laborkittel lässt sich die Luke öffnen
You open Xeno Lab Luke.

>Antigravitationsgreifer anstoßen
Der Antigravitations is in den Raum über dir geschebt.
Die Xeno Luke ist versperrt. Ich kann nun hindurch gehen.

>u
Xeno Lab
Du bist im Xeno Lab.

You can see Xeno Lab Luke and Antigravitationsgreifer here.

>Antigravitationsgreifer anstoßen
Die Palette bleibt im Raum, da sie nirgens hinschweben kann.

* * *

Lupus
An Interactive Fiction by Gruppe 8
Release 1 / Serial number 180529 / Inform 7 build 6M62 (I6/v6.33 lib 6/12N) SD

Hangar
Du bist in dem Hangar.

You can see Hangar-Luke, Tür zwischen Andockbucht und Hangar, Blinkender_Knopf, Sicherheitsausweis and Barry here.

>wait
Time passes.

>up
(first opening Hangar-Luke)
It seems to be locked.

>take all
Blinkender_Knopf: Taken.
Sicherheitsausweis: Taken.

>up
(first opening Hangar-Luke)
It seems to be locked.

>open
What do you want to open?

>tür_Hang
You can't see any such thing.

>open hangar_luke
You can't see any such thing.

>open tür_HangarZUGammakreuz
You can't see any such thing.

>open luke_HangarZUGammakreuz
It seems to be locked.

>unlock luke_HangarZUGammakreuz
What do you want to unlock Hangar-Luke with?

>sicherheitsausweis
That doesn't seem to fit the lock.

>bennutz up
That's not a verb I recognise.

>benutze sa up
Der Durchgang ist nun offen.

>up
Gamma-Kreuzung
Du bist in der Gamma-Kreuzung.

You can see Xeno Lab Luke, Hangar-Luke, Tür zwischen Gamma Kreuzung und Gamma Delta Kreuzung, Tür zwischen Gamma Beta Kreuzung und Gamma Kreuzung, Laborkittel and Leiche here.

Die Luke zwischen Hangar und Gamma Kreuzung schließt sich wieder.

>wait
Time passes.

* * *

Lupus
An Interactive Fiction by Gruppe 8
Release 1 / Serial number 180529 / Inform 7 build 6M62 (I6/v6.33 lib 6/12N) SD

Hangar
Du bist in dem Hangar.

You can see Hangar-Luke, Tür zwischen Andockbucht und Hangar, Blinkender_Knopf, Sicherheitsausweis and Barry here.

>n
You can't go that way.

* * *

>s
You can't go that way.

>w
You can't go that way.

>e
You can't go that way.

>f
That's not a verb I recognise.

>d
(first opening Tür zwischen Andockbucht und Hangar)

Andockbucht
Du bist in der Andockbucht.

You can see Tür zwischen Andockbucht und Kommunkationsbasis, Tür zwischen Andockbucht und Hangar and Raumfähre (in which are Antigravitationsgreifer and Palette) here.

* * *

Lupus
An Interactive Fiction by Gruppe 8
Release 1 / Serial number 180529 / Inform 7 build 6M62 (I6/v6.33 lib 6/12N) SD

Hangar
Du bist in dem Hangar.

You can see Hangar-Luke, Tür zwischen Andockbucht und Hangar, Blinkender_Knopf, Sicherheitsausweis and Barry here.

>s
You can't go that way.

>f
That's not a verb I recognise.

>d
(first opening Tür zwischen Andockbucht und Hangar)

Andockbucht
Du bist in der Andockbucht.

You can see Tür zwischen Andockbucht und Kommunkationsbasis, Tür zwischen Andockbucht und Hangar and Raumfähre (in which are Antigravitationsgreifer and Palette) here.

Maschinenkern

* * *

Lupus
An Interactive Fiction by Gruppe 8
Release 1 / Serial number 180529 / Inform 7 build 6M62 (I6/v6.33 lib 6/12N) SD

Hangar
Du bist in dem Hangar.

You can see Hangar-Luke, Tür zwischen Andockbucht und Hangar, Blinkender_Knopf, Sicherheitsausweis and Barry here.

>d
(first opening Tür zwischen Andockbucht und Hangar)

Andockbucht
Du bist in der Andockbucht.

You can see Tür zwischen Andockbucht und Kommunkationsbasis, Tür zwischen Andockbucht und Hangar and Raumfähre (in which are Antigravitationsgreifer and Palette) here.

*** Run-time problem P31: Attempt to use a property of the 'nothing' non-object: property farbe