Lupus
An Interactive Fiction by Gruppe 8
Release 1 / Serial number 180509 / Inform 7 build 6M62 (I6/v6.33 lib 6/12N) SD

Andockbucht
Du bist in der Andockbucht.

You can see Tür zwischen Andockbucht und Hangar and You here.

>up
(first opening Tür zwischen Andockbucht und Hangar)

Hangar
Du bist in dem Hangar.

You can see Tür zwischen Andockbucht und Hangar here.

>up
You can't go that way.

>down
Andockbucht
Du bist in der Andockbucht.

You can see Tür zwischen Andockbucht und Hangar and You here.

>close Tür
You can't see any such thing.

>close Tür zwischen Andockbucht und Hangar
You can't see any such thing.