Lupus
An Interactive Fiction by Gruppe 8
Release 1 / Serial number 180705 / Inform 7 build 6M62 (I6/v6.33 lib 6/12N) SD

Andockbucht
Du bist in der Andockbucht.

You can see Tür zwischen Andockbucht und Kommunkationsbasis, Tür zwischen Andockbucht und Hangar and Raumfähre (in which are Antigravitationsgreifer and Palette) here.

>look
Andockbucht
Du bist in der Andockbucht.

You can see Tür zwischen Andockbucht und Kommunkationsbasis, Tür zwischen Andockbucht und Hangar and Raumfähre (in which are Antigravitationsgreifer and Palette) here.

TEST

>up
(first opening Tür zwischen Andockbucht und Hangar)

Hangar
Du bist in dem Hangar.

Barry standing  in der Nähe.

You can also see Hangar-Luke, Tür zwischen Andockbucht und Hangar and a Spind (in which are Sicherheitsausweis, a Druha and Mobitab) here.

TEST

>take druha
Ich brauche keinen Druchlufthammer.

TEST

>take mobitab
Ich brauche kein Mobitab.

TEST

>take sa
Taken.

TEST

* * *

Lupus
An Interactive Fiction by Gruppe 8
Release 1 / Serial number 180705 / Inform 7 build 6M62 (I6/v6.33 lib 6/12N) SD

Andockbucht
Du bist in der Andockbucht.

You can see Tür zwischen Andockbucht und Kommunkationsbasis, Tür zwischen Andockbucht und Hangar and Raumfähre (in which are Antigravitationsgreifer and Palette) here.

>u
(first opening Tür zwischen Andockbucht und Hangar)

Hangar
Du bist in dem Hangar.

Barry standing  in der Nähe.

You can also see Hangar-Luke, Tür zwischen Andockbucht und Hangar, a Spind (in which are Sicherheitsausweis, a Druha and Mobitab) and Umkleidekabine (closed) here.

TEST

>take umkleide
You can't see any such thing.

>take umkleidekabine
That's fixed in place.

TEST

>take spind
That's fixed in place.

TEST

* * *

>u
(first opening Tür zwischen Andockbucht und Hangar)

Hangar
Du bist in dem Hangar.

Barry standing  in der Nähe.

You can also see Hangar-Luke, Tür zwischen Andockbucht und Hangar, a Spind (in which are Sicherheitsausweis, a Druha and Mobitab) and Umkleidekabine (closed) here.

TEST

>look umkleidekabine
Eine Umkleidekabine, in der die Besatzung ihr Equipment für Außeneinsätze aufbewahrt.

TEST

>enter
You can't get into the closed Umkleidekabine.

TEST

>take raumanzug
You can't see any such thing.

I beg your pardon?

* * *

Lupus
An Interactive Fiction by Gruppe 8
Release 1 / Serial number 180705 / Inform 7 build 6M62 (I6/v6.33 lib 6/12N) SD

Andockbucht
Du bist in der Andockbucht.

You can see Tür zwischen Andockbucht und Kommunkationsbasis, Tür zwischen Andockbucht und Hangar and Raumfähre (in which are Antigravitationsgreifer and Palette) here.

>wait
Time passes.

>up
(first opening Tür zwischen Andockbucht und Hangar)

Hangar
Du bist in dem Hangar.

Barry standing  in der Nähe.

You can also see Hangar-Luke, Tür zwischen Andockbucht und Hangar, a Spind (in which are Sicherheitsausweis, a Druha and Mobitab) and Umkleidekabine (closed) here.

>look
Hangar
Du bist in dem Hangar.

Barry standing  in der Nähe.

You can also see Hangar-Luke, Tür zwischen Andockbucht und Hangar, a Spind (in which are Sicherheitsausweis, a Druha and Mobitab) and Umkleidekabine (closed) here.

TEST

>look
Hangar
Du bist in dem Hangar.

Barry standing  in der Nähe.

You can also see Hangar-Luke, Tür zwischen Andockbucht und Hangar, a Spind (in which are Sicherheitsausweis, a Druha and Mobitab) and Umkleidekabine (closed) here.

TEST

* * *

>up
(first opening Tür zwischen Andockbucht und Hangar)

Hangar
Du bist in dem Hangar.

Barry standing  in der Nähe.

You can also see Hangar-Luke, Tür zwischen Andockbucht und Hangar, a Spind (in which are Sicherheitsausweis, a Druha and Mobitab) and Umkleidekabine (closed) here.

>take sa
Taken.

>benutzen sa up
That's not a verb I recognise.

>benutze sa up
Der Durchgang ist nun offen.

>up
Gamma-Kreuzung
Du bist in der Gamma-Kreuzung.

You can see Xeno Lab Luke, Hangar-Luke, Tür zwischen Gamma Kreuzung und Gamma Delta Kreuzung, Tür zwischen Gamma Beta Kreuzung und Gamma Kreuzung, Laborkittel and Leiche here.

Du hörst den Stationsalarm, der die meisten Geräusche übertönen würde.

Die Luke zwischen Hangar und Gamma Kreuzung schließt sich wieder.

>n
(first opening Tür zwischen Gamma Kreuzung und Gamma Delta Kreuzung)
It seems to be locked.

Du hörst den Stationsalarm, der die meisten Geräusche übertönen würde.

>benutze sa n
Der Durchgang ist nun offen.

>n
Gamma-Delta-Korridor
Du bist in dem Gamma-Delta-Korridor.

You can see Tür zwischen Gamma Delta Kreuzung und Delta Kreuzung, Tür zwischen Gamma Kreuzung und Gamma Delta Kreuzung, Luke zwischen KommunikationsModul und Gamma Delta Korridor. and Hebel here.

Du hörst den Stationsalarm, der die meisten Geräusche übertönen würde.

>benutze sa n
Der Durchgang ist nun offen.

>n
Delta-Kreuzung
Du bist in der Delta-Kreuzung.

You can see Solar Lab Luke, Tür zwischen Delta Kreuzung und Alpha Delta Kreuzung and Tür zwischen Gamma Delta Kreuzung und Delta Kreuzung here.

Du hörst den Stationsalarm, der die meisten Geräusche übertönen würde.

>up
(first opening Solar Lab Luke)

Solar Lab
Du bist im Solar Lab. Durch das Fenster in der Decke kannst du den Maschinenkern grün glühen sehen.

You can see Solar Lab Luke here.

>d
Delta-Kreuzung
Du bist in der Delta-Kreuzung.

You can see Solar Lab Luke, Tür zwischen Delta Kreuzung und Alpha Delta Kreuzung and Tür zwischen Gamma Delta Kreuzung und Delta Kreuzung here.

Du hörst den Stationsalarm, der die meisten Geräusche übertönen würde.

>benutze sa n
Der Durchgang ist nun offen.

>n
Alpha-Delta-Korridor
Du bist in dem Alpha-Delta-Korridor.

Kontaminierter standing  in der Nähe.

You can also see Tür zwischen Alpha Delta Kreuzung und Alpha Kreuzung and Tür zwischen Delta Kreuzung und Alpha Delta Kreuzung here.

Du hörst den Stationsalarm, der die meisten Geräusche übertönen würde.

>benutze sa n
Der Durchgang ist nun offen.

>n
Alpha-Kreuzung
Du bist in der Alpha-Kreuzung.

You can see Med Lab Luke, Tür zwischen Alpha Kreuzung und Alpha Beta Kreuzung, Tür zwischen Alpha Delta Kreuzung und Alpha Kreuzung and Tür zwischen Alpha Kreuzung und Dienstzimmer here.

Du hörst den Stationsalarm, der die meisten Geräusche übertönen würde.

>up
(first opening Med Lab Luke)

Med Lab
Du bist im Med Lab. Durch das Fenster in der Decke kannst du den Maschinenkern grün glühen sehen.

Kontaminierter standing  in der Nähe.

Es scheint einer Art Videoblog auf dem Pult gespeichert zu sein.
Nutze "Videoblog anschauen".

You can also see Med Lab Luke and Krankenbett (empty) here.

>klatschen kontaminierter
You can't see any such thing.

>d
Alpha-Kreuzung
Du bist in der Alpha-Kreuzung.

You can see Med Lab Luke, Tür zwischen Alpha Kreuzung und Alpha Beta Kreuzung, Tür zwischen Alpha Delta Kreuzung und Alpha Kreuzung and Tür zwischen Alpha Kreuzung und Dienstzimmer here.

Du hörst den Stationsalarm, der die meisten Geräusche übertönen würde.

>u
Med Lab
Du bist im Med Lab. Durch das Fenster in der Decke kannst du den Maschinenkern grün glühen sehen.

Kontaminierter standing  in der Nähe.

Es scheint einer Art Videoblog auf dem Pult gespeichert zu sein.
Nutze "Videoblog anschauen".

You can also see Med Lab Luke and Krankenbett (empty) here.

>rufen
(Sicherheitsausweis)

>d
Alpha-Kreuzung
Du bist in der Alpha-Kreuzung.

You can see Med Lab Luke, Tür zwischen Alpha Kreuzung und Alpha Beta Kreuzung, Tür zwischen Alpha Delta Kreuzung und Alpha Kreuzung and Tür zwischen Alpha Kreuzung und Dienstzimmer here.

Du hörst den Stationsalarm, der die meisten Geräusche übertönen würde.

>rufen
(Sicherheitsausweis)
Du hörst den Stationsalarm, der die meisten Geräusche übertönen würde.

>up
Med Lab
Du bist im Med Lab. Durch das Fenster in der Decke kannst du den Maschinenkern grün glühen sehen.

Kontaminierter standing  in der Nähe.

Es scheint einer Art Videoblog auf dem Pult gespeichert zu sein.
Nutze "Videoblog anschauen".

You can also see Med Lab Luke and Krankenbett (empty) here.

>look kontaminierter
You can't see any such thing.

>look Kontaminierter
You can't see any such thing.

>wait
Time passes.

>wait
Time passes.

Der Kontaminierte kommt dir ziemlich nah. Du solltest besser verschwinden.

>d
Alpha-Kreuzung
Du bist in der Alpha-Kreuzung.

You can see Med Lab Luke, Tür zwischen Alpha Kreuzung und Alpha Beta Kreuzung, Tür zwischen Alpha Delta Kreuzung und Alpha Kreuzung and Tür zwischen Alpha Kreuzung und Dienstzimmer here.

Du hörst den Stationsalarm, der die meisten Geräusche übertönen würde.

* * *

>u
Med Lab
Du bist im Med Lab. Durch das Fenster in der Decke kannst du den Maschinenkern grün glühen sehen.

Kontaminierter standing  in der Nähe.

Es scheint einer Art Videoblog auf dem Pult gespeichert zu sein.
Nutze "Videoblog anschauen".

You can also see Med Lab Luke and Krankenbett (empty) here.

>look
Med Lab
Du bist im Med Lab. Durch das Fenster in der Decke kannst du den Maschinenkern grün glühen sehen.

Kontaminierter standing  in der Nähe.

Es scheint einer Art Videoblog auf dem Pult gespeichert zu sein.
Nutze "Videoblog anschauen".

You can also see Med Lab Luke and Krankenbett (empty) here.

>klatschen
(Sicherheitsausweis)
Der Kontaminierte kommt dir ziemlich nah. Du solltest besser verschwinden.

>d
Alpha-Kreuzung
Du bist in der Alpha-Kreuzung.

You can see Med Lab Luke, Tür zwischen Alpha Kreuzung und Alpha Beta Kreuzung, Tür zwischen Alpha Delta Kreuzung und Alpha Kreuzung and Tür zwischen Alpha Kreuzung und Dienstzimmer here.

Du hörst den Stationsalarm, der die meisten Geräusche übertönen würde.

>up
Med Lab
Du bist im Med Lab. Durch das Fenster in der Decke kannst du den Maschinenkern grün glühen sehen.

Kontaminierter standing  in der Nähe.

Es scheint einer Art Videoblog auf dem Pult gespeichert zu sein.
Nutze "Videoblog anschauen".

You can also see Med Lab Luke and Krankenbett (empty) here.

>klatschen
(Sicherheitsausweis)

>wait
Time passes.

Der Kontaminierte kommt dir ziemlich nah. Du solltest besser verschwinden.

* * *

Lupus
An Interactive Fiction by Gruppe 8
Release 1 / Serial number 180705 / Inform 7 build 6M62 (I6/v6.33 lib 6/12N) SD

Andockbucht
Du bist in der Andockbucht.

You can see Tür zwischen Andockbucht und Kommunkationsbasis, Tür zwischen Andockbucht und Hangar and Raumfähre (in which are Antigravitationsgreifer and Palette) here.

>up
(first opening Tür zwischen Andockbucht und Hangar)

Hangar
Du bist in dem Hangar.

Barry standing  in der Nähe.

You can also see Hangar-Luke, Tür zwischen Andockbucht und Hangar, a Spind (in which are Sicherheitsausweis, a Druha and Mobitab) and Umkleidekabine (closed) here.

>look
Hangar
Du bist in dem Hangar.

Barry standing  in der Nähe.

You can also see Hangar-Luke, Tür zwischen Andockbucht und Hangar, a Spind (in which are Sicherheitsausweis, a Druha and Mobitab) and Umkleidekabine (in which is a Raumanzug) here.

TEST

>enter umkleidekabine
You get into Umkleidekabine.

In Umkleidekabine you can see a Raumanzug.

TEST

* * *

>up
(first opening Tür zwischen Andockbucht und Hangar)

Hangar
Du bist in dem Hangar.

Barry standing  in der Nähe.

You can also see Hangar-Luke, Tür zwischen Andockbucht und Hangar, a Spind (in which are Sicherheitsausweis, a Druha and Mobitab) and Umkleidekabine (closed) here.

>take druha
Ich brauche keinen Druchlufthammer.

* * *

>take sa
Taken.

>benutze sa up
Der Durchgang ist nun offen.

>u
Gamma-Kreuzung
Du bist in der Gamma-Kreuzung.

You can see Xeno Lab Luke, Hangar-Luke, Tür zwischen Gamma Kreuzung und Gamma Delta Kreuzung, Tür zwischen Gamma Beta Kreuzung und Gamma Kreuzung, Laborkittel and Leiche here.

Du hörst den Stationsalarm, der die meisten Geräusche übertönen würde.

Die Luke zwischen Hangar und Gamma Kreuzung schließt sich wieder.

>up
Ich kann hier nicht durchgehen. Ich muss etwas finden um die Luke zu versperren.

Du hörst den Stationsalarm, der die meisten Geräusche übertönen würde.

>open xeno_luke
You can't see any such thing.

>open luke_xeno
Ich benötige eine Art Transponder um diese Tür zu entsperren
Du hörst den Stationsalarm, der die meisten Geräusche übertönen würde.

>look
Gamma-Kreuzung
Du bist in der Gamma-Kreuzung.

You can see Xeno Lab Luke, Hangar-Luke, Tür zwischen Gamma Kreuzung und Gamma Delta Kreuzung, Tür zwischen Gamma Beta Kreuzung und Gamma Kreuzung, Laborkittel and Leiche here.

Du hörst den Stationsalarm, der die meisten Geräusche übertönen würde.

>take laborkittel
Taken.

Du hörst den Stationsalarm, der die meisten Geräusche übertönen würde.

>open luke_xeno
Ich benötige eine Art Transponder um diese Tür zu entsperren
Du hörst den Stationsalarm, der die meisten Geräusche übertönen würde.

>unlock luke-xeno
You can't see any such thing.

>wear laborkittel
You put on Laborkittel.

Du hörst den Stationsalarm, der die meisten Geräusche übertönen würde.

>open luke_xeno
Mit dem Transponder im Laborkittel lässt sich die Luke öffnen
You open Xeno Lab Luke.

Du hörst ein ohrenbetäubendes Pfeifen.

Du hörst den Stationsalarm, der die meisten Geräusche übertönen würde.

* * *

>u
Gamma-Kreuzung
Du bist in der Gamma-Kreuzung.

You can see Xeno Lab Luke, Hangar-Luke, Tür zwischen Gamma Kreuzung und Gamma Delta Kreuzung, Tür zwischen Gamma Beta Kreuzung und Gamma Kreuzung, Laborkittel and Leiche here.

Du hörst den Stationsalarm, der die meisten Geräusche übertönen würde.

Die Luke zwischen Hangar und Gamma Kreuzung schließt sich wieder.

>wear laborkittel
(first taking Laborkittel)
You put on Laborkittel.

Du hörst den Stationsalarm, der die meisten Geräusche übertönen würde.

>open luke_xeno
Mit dem Transponder im Laborkittel lässt sich die Luke öffnen
You open Xeno Lab Luke.

Du hörst ein ohrenbetäubendes Pfeifen.

* * *

Lupus
An Interactive Fiction by Gruppe 8
Release 1 / Serial number 180705 / Inform 7 build 6M62 (I6/v6.33 lib 6/12N) SD

Andockbucht
Du bist in der Andockbucht.

You can see Tür zwischen Andockbucht und Kommunkationsbasis, Tür zwischen Andockbucht und Hangar and Raumfähre (in which are Antigravitationsgreifer and Palette) here.

>wait 10 times
I only understood you as far as wanting to wait.

>wait 10
I only understood you as far as wanting to wait.

>x10 wait
That's not a verb I recognise.

>10wait
That's not a verb I recognise.

>10 wait
That's not a verb I recognise.

>wait times 10
I only understood you as far as wanting to wait.

>waitx10
That's not a verb I recognise.

>wait x 10
I only understood you as far as wanting to wait.

>wait(10)
That's not a verb I recognise.

* * *

Lupus
An Interactive Fiction by Gruppe 8
Release 1 / Serial number 180705 / Inform 7 build 6M62 (I6/v6.33 lib 6/12N) SD

Andockbucht
Du bist in der Andockbucht.

You can see Tür zwischen Andockbucht und Kommunkationsbasis, Tür zwischen Andockbucht und Hangar and Raumfähre (in which are Antigravitationsgreifer and Palette) here.

>n
(first opening Tür zwischen Andockbucht und Kommunkationsbasis)
Ich benötige einen Raumanzug um hier durch zu gehen
TEST

>up
(first opening Tür zwischen Andockbucht und Hangar)

Hangar
Du bist in dem Hangar.

Barry standing  in der Nähe.

You can also see Hangar-Luke, Tür zwischen Andockbucht und Hangar, a Spind (in which are Sicherheitsausweis, a Druha and Mobitab) and Umkleidekabine (closed) here.

>look
Hangar
Du bist in dem Hangar.

Barry standing  in der Nähe.

You can also see Hangar-Luke, Tür zwischen Andockbucht und Hangar, a Spind (in which are Sicherheitsausweis, a Druha and Mobitab) and Umkleidekabine (closed) here.

>d
Andockbucht
Du bist in der Andockbucht.

You can see Tür zwischen Andockbucht und Hangar, Tür zwischen Andockbucht und Kommunkationsbasis and Raumfähre (in which are Antigravitationsgreifer and Palette) here.

TEST